
         G  #                   
        ############             
  #                #             
  #####            #
                   ###############
  M    #      #
####################################################