
#G#
###
      G
      ##
         G G#                   
        ############             
  #                #             
  #####            #
                   ###############
  M    #      #
####################################################