                                    ###  # #  # #  ###  ###  ###  ###  # #  ###  ###  ###  #     # #  ###  ###  ###  ###    ###  # #  ##
                                    #    # #  # #   #   #     #   #    ###   #    #   #    #     # #  # #   #   #    #      #    # #  # #  ###
                                    ##   # #   #    #   ###   #   ##   # #   #    #   ##   #     ##   ##    #   ###  ##     ##   # #  # #    #
        ############                #    # #  # #   #     #   #   #    # #   #    #   #    #     # #  # #   #     #  #      #    # #  # #    #   
                   #                ###  ###  # #  ###  ###   #   ###  # #   #   ###  ###  ###   # #  # #  ###  ###  ###    ###  ###  ##   # # #
                   #                                                                                                                        ###
                   ###############                                                                                                           #
                                       M
#########################################################################################################################################         ########