                                    ###  # #  # #  ###  ###  ###  ###  # #  ###  ###  ###  #     # #  ###  ###  ###  ###
                                    #    # #  # #   #   #     #   #    ###   #    #   #    #     # #  # #   #   #    #
           @                        ##   # #   #    #   ###   #   ##   # #   #    #   ##   #     ##   ##    #   ###  ##
        ############                #    # #  # #   #     #   #   #    # #   #    #   #    #     # #  # #   #     #  #
                   #                ###  ###  # #  ###  ###   #   ###  # #   #   ###  ###  ###   # #  # #  ###  ###  ###
                   #
                   ###############
   
##############################################################################################################################